data,sample,sattr,strategy,n_sg,anony_mode,info_loss,alpha_adm,alpha_dm,k,w,l,reset_w,calgo,enforcer_str,enforcer,enforcer_name,max_dist,snapshot_id,algo,galgo,AIL,dm,am,AAIL,num_anonymized_fake_entities,num_anonymized_real_entities,num_real_edges,num_fake_edges,num_raw_entities,num_anonymized_entities,num_raw_edges,num_anonymized_edges,anonymized_anonymity,anonymized_attribute_anonymity,anonymized_degree_anonymity,num_removed_entities,num_removed_edges
yago15,-1,isCitizenOf,mean,10,all,adm,0.5,0.5,6,-1,1,-1,km,gs#0.00,gs,gs,0.0,6,tanga,ad2,0.20442000413445785,0.2038508918067216,0.20498911646219148,0.012651741437337794,44,3640,6009,22527,4528,3684,7425,28536,1,6,1,888,1416
yago15,-1,isCitizenOf,mean,10,all,adm,0.5,0.5,10,-1,2,-1,km,gs#0.00,gs,gs,0.0,7,tanga,ad2,0.29855391262236597,0.2975191024347925,0.2995887228099429,0.014982190808373711,45,3282,5672,42033,4627,3327,7777,47705,1,10,1,1345,2105
yago15,-1,isCitizenOf,mean,10,all,adm,0.5,0.5,10,-1,2,-1,km,gs#0.00,gs,gs,0.0,9,tanga,ad2,0.29929201156956337,0.2981742940219455,0.30040972911718056,0.014978467603579142,48,3533,6834,52777,4986,3581,9350,59611,1,10,1,1453,2516
yago15,-1,isCitizenOf,mean,10,all,adm,0.5,0.5,6,-1,1,-1,km,gs#0.00,gs,gs,0.0,7,tanga,ad2,0.20575244934393547,0.20517343387791623,0.20633146480995287,0.01450980978094811,52,3719,6292,24025,4627,3771,7777,30317,1,6,1,908,1485
yago15,-1,isCitizenOf,mean,10,all,adm,0.5,0.5,10,-1,4,1,km,gs#0.00,gs,gs,0.0,0,tanga,ad2,0.12373208542362588,0.12301462534407387,0.12444954550317748,0.011679860959661477,43,3914,5920,42230,4420,3957,7113,48150,1,10,1,506,1193
yago15,-1,isCitizenOf,mean,10,all,adm,0.5,0.5,10,-1,1,-1,km,gs#0.00,gs,gs,0.0,4,tanga,ad2,0.26036513603956507,0.25936710976361155,0.261363162315517,0.013164143625441663,40,3341,5523,40391,4471,3381,7242,45914,1,10,1,1130,1719
yago15,-1,isCitizenOf,mean,10,all,adm,0.5,0.5,10,-1,4,1,km,gs#0.00,gs,gs,0.0,3,tanga,ad2,0.12153147779942036,0.12081092433307074,0.12225203126576835,0.011805388085134764,44,3959,6038,42769,4459,4003,7220,48807,1,10,1,500,1182
yago15,-1,isCitizenOf,mean,10,all,adm,0.5,0.5,10,-1,1,-1,km,gs#0.00,gs,gs,0.0,3,tanga,ad2,0.26002556873966487,0.25894721807483717,0.2611039194044895,0.013294494058714242,40,3334,5520,40412,4459,3374,7220,45932,1,10,1,1125,1700
yago15,-1,isCitizenOf,mean,10,all,adm,0.5,0.5,8,-1,1,-1,km,gs#0.00,gs,gs,0.0,4,tanga,ad2,0.23449701520812644,0.23360072509556817,0.2353933053206825,0.012875527128952183,41,3458,5776,31789,4471,3499,7242,37565,1,8,1,1013,1466
yago15,-1,isCitizenOf,mean,10,all,adm,0.5,0.5,10,-1,4,-1,km,gs#0.00,gs,gs,0.0,1,tanga,ad2,0.2878657781219553,0.2869267540686819,0.2888048021752288,0.017610188165105425,53,3196,5295,38621,4429,3249,7145,43916,1,10,1,1233,1850
yago15,-1,isCitizenOf,mean,10,all,adm,0.5,0.5,8,-1,1,-1,km,gs#0.00,gs,gs,0.0,7,tanga,ad2,0.23695072747894472,0.23607629274485628,0.23782516221303146,0.012499751582669937,41,3566,6162,34744,4627,3607,7777,40906,1,8,1,1061,1615
yago15,-1,isCitizenOf,mean,10,all,adm,0.5,0.5,10,-1,4,1,km,gs#0.00,gs,gs,0.0,1,tanga,ad2,0.1211311924160861,0.12042249858444676,0.12183988624772304,0.012596361162701308,47,3937,5975,41853,4429,3984,7145,47828,1,10,1,492,1170
yago15,-1,isCitizenOf,mean,10,all,adm,0.5,0.5,6,-1,1,-1,km,gs#0.00,gs,gs,0.0,1,tanga,ad2,0.21051317325672017,0.21005718922630415,0.21096915728713359,0.013417254820925787,46,3535,5698,20739,4429,3581,7145,26437,1,6,1,894,1447
yago15,-1,isCitizenOf,mean,10,all,adm,0.5,0.5,10,-1,2,-1,km,gs#0.00,gs,gs,0.0,6,tanga,ad2,0.29951039244300554,0.2984927981957446,0.3005279866902674,0.015266695276710032,45,3208,5418,39505,4528,3253,7425,44923,1,10,1,1320,2007
yago15,-1,isCitizenOf,mean,10,all,adm,0.5,0.5,10,-1,4,1,km,gs#0.00,gs,gs,0.0,4,tanga,ad2,0.12147096025435794,0.12074511244941122,0.12219680805930212,0.0134820610636043,51,3976,6065,43407,4471,4027,7242,49472,1,10,1,495,1177
yago15,-1,isCitizenOf,mean,10,all,adm,0.5,0.5,10,-1,3,-1,km,gs#0.00,gs,gs,0.0,5,tanga,ad2,0.2560313581445652,0.25491733593237165,0.25714538035675777,0.014356367926330832,44,3373,5615,40611,4483,3417,7287,46226,1,10,1,1110,1672
yago15,-1,isCitizenOf,mean,10,all,adm,0.5,0.5,10,-1,4,1,km,gs#0.00,gs,gs,0.0,9,tanga,ad2,0.11755703114163912,0.1167151246398752,0.11839893764340184,0.012495105660361187,52,4450,7916,56718,4986,4502,9350,64634,1,10,1,536,1434
yago15,-1,isCitizenOf,mean,10,all,adm,0.5,0.5,10,-1,2,-1,km,gs#0.00,gs,gs,0.0,5,tanga,ad2,0.3018064001637668,0.30079672106968414,0.30281607925784965,0.015440961969341022,45,3166,5303,38424,4483,3211,7287,43727,1,10,1,1317,1984
yago15,-1,isCitizenOf,mean,10,all,adm,0.5,0.5,10,-1,4,-1,km,gs#0.00,gs,gs,0.0,3,tanga,ad2,0.2953949609481576,0.294340642595907,0.2964492793004078,0.0157380498996864,46,3179,5279,38607,4459,3225,7220,43886,1,10,1,1280,1941
yago15,-1,isCitizenOf,mean,10,all,adm,0.5,0.5,6,-1,1,-1,km,gs#0.00,gs,gs,0.0,9,tanga,ad2,0.20908682667897313,0.20845823221077422,0.20971542114717076,0.019159344253018896,75,4006,7589,30567,4986,4081,9350,38156,1,6,1,980,1761
yago15,-1,isCitizenOf,mean,10,all,adm,0.5,0.5,6,-1,1,-1,km,gs#0.00,gs,gs,0.0,0,tanga,ad2,0.1580213409774482,0.15773219821605458,0.1583104837388394,0.010103457294139605,37,3754,5565,19166,4420,3791,7113,24731,1,6,1,666,1548
yago15,-1,isCitizenOf,mean,10,all,adm,0.5,0.5,10,-1,3,-1,km,gs#0.00,gs,gs,0.0,4,tanga,ad2,0.25670536243547576,0.25559485362560347,0.2578158712453475,0.01439837471372842,44,3361,5576,40243,4471,3405,7242,45819,1,10,1,1110,1666
yago15,-1,isCitizenOf,mean,10,all,adm,0.5,0.5,10,-1,4,1,km,gs#0.00,gs,gs,0.0,6,tanga,ad2,0.12349226894007585,0.12276359327503407,0.12422094460511574,0.013120596591901864,50,4016,6204,44302,4528,4066,7425,50506,1,10,1,512,1221
yago15,-1,isCitizenOf,mean,10,all,adm,0.5,0.5,10,-1,3,-1,km,gs#0.00,gs,gs,0.0,9,tanga,ad2,0.26053902490642644,0.2593274714978579,0.2617505783149937,0.015874944644321005,54,3733,7176,55028,4986,3787,9350,62204,1,10,1,1253,2174
yago15,-1,isCitizenOf,mean,10,all,adm,0.5,0.5,2,-1,1,-1,km,gs#0.00,gs,gs,0.0,9,tanga,ad2,0.09317239506475843,0.09306146258863009,0.09328332754088718,0.0001233503373532712,0,4522,8479,5996,4986,4522,9350,14475,1,2,1,464,871
yago15,-1,isCitizenOf,mean,10,all,adm,0.5,0.5,8,-1,1,-1,km,gs#0.00,gs,gs,0.0,5,tanga,ad2,0.23626808288970474,0.23541198586417156,0.23712417991523552,0.012822104684808388,41,3459,5791,31893,4483,3500,7287,37684,1,8,1,1024,1496
yago15,-1,isCitizenOf,mean,10,all,adm,0.5,0.5,4,-1,1,-1,km,gs#0.00,gs,gs,0.0,4,tanga,ad2,0.14361299394018792,0.14326854430953057,0.14395744357084442,0.013639380377752088,52,3875,6340,13344,4471,3927,7242,19684,1,4,1,596,902
yago15,-1,isCitizenOf,mean,10,all,adm,0.5,0.5,6,-1,1,-1,km,gs#0.00,gs,gs,0.0,3,tanga,ad2,0.200887964687002,0.2003116682544253,0.20146426111957516,0.012784337479011434,44,3601,5852,21660,4459,3645,7220,27512,1,6,1,858,1368
yago15,-1,isCitizenOf,mean,10,all,adm,0.5,0.5,4,-1,1,-1,km,gs#0.00,gs,gs,0.0,8,tanga,ad2,0.1500470667204643,0.14967318362588622,0.15042094981503987,0.015377176752909163,63,4153,7485,16885,4821,4216,8604,24370,1,4,1,668,1119
yago15,-1,isCitizenOf,mean,10,all,adm,0.5,0.5,2,-1,1,-1,km,gs#0.00,gs,gs,0.0,4,tanga,ad2,0.09312861673695981,0.09304499720633105,0.09321223626758726,9.328236042079932e-05,0,4055,6467,3933,4471,4055,7242,10400,1,2,1,416,775
yago15,-1,isCitizenOf,mean,10,all,adm,0.5,0.5,10,-1,3,-1,km,gs#0.00,gs,gs,0.0,2,tanga,ad2,0.2504839440263299,0.24938794978765452,0.2515799382650042,0.014350394366679824,44,3365,5562,39979,4439,3409,7178,45541,1,10,1,1074,1616
yago15,-1,isCitizenOf,mean,10,all,adm,0.5,0.5,10,-1,3,-1,km,gs#0.00,gs,gs,0.0,7,tanga,ad2,0.25317387734097835,0.2520348227771171,0.25431293190483834,0.014771781079790741,47,3496,5995,44406,4627,3543,7777,50401,1,10,1,1131,1782
yago15,-1,isCitizenOf,mean,10,all,adm,0.5,0.5,6,-1,1,-1,km,gs#0.00,gs,gs,0.0,8,tanga,ad2,0.2102685650113387,0.20966569372589033,0.21087143629678454,0.01681176632422169,63,3860,6927,27273,4821,3923,8604,34200,1,6,1,961,1677
yago15,-1,isCitizenOf,mean,10,all,adm,0.5,0.5,10,-1,3,-1,km,gs#0.00,gs,gs,0.0,0,tanga,ad2,0.12414021124972922,0.12343552281252743,0.12484489968692936,0.011918862566151139,44,3913,5935,41843,4420,3957,7113,47778,1,10,1,507,1178
yago15,-1,isCitizenOf,mean,10,all,adm,0.5,0.5,10,-1,3,-1,km,gs#0.00,gs,gs,0.0,1,tanga,ad2,0.2493577939867979,0.24838056832936983,0.25033501964422633,0.014203874488464087,44,3362,5535,39718,4429,3406,7145,45253,1,10,1,1067,1610
yago15,-1,isCitizenOf,mean,10,all,adm,0.5,0.5,10,-1,4,1,km,gs#0.00,gs,gs,0.0,5,tanga,ad2,0.12260270102893377,0.12185642929891037,0.1233489727589555,0.012519463216919604,47,3978,6102,44563,4483,4025,7287,50665,1,10,1,505,1185
yago15,-1,isCitizenOf,mean,10,all,adm,0.5,0.5,10,-1,1,-1,km,gs#0.00,gs,gs,0.0,1,tanga,ad2,0.24651398919430237,0.24552873314697554,0.24749924524162648,0.013875110780434874,43,3374,5555,40518,4429,3417,7145,46073,1,10,1,1055,1590
yago15,-1,isCitizenOf,mean,10,all,adm,0.5,0.5,10,-1,1,-1,km,gs#0.00,gs,gs,0.0,7,tanga,ad2,0.2605091028439312,0.25948283837266695,0.2615353673151944,0.012813803188156246,40,3456,5924,44355,4627,3496,7777,50279,1,10,1,1171,1853
yago15,-1,isCitizenOf,mean,10,all,adm,0.5,0.5,10,-1,1,-1,km,gs#0.00,gs,gs,0.0,6,tanga,ad2,0.26020480604273727,0.25919539739633946,0.26121421468913236,0.01303046680372587,40,3384,5673,41856,4528,3424,7425,47529,1,10,1,1144,1752
yago15,-1,isCitizenOf,mean,10,all,adm,0.5,0.5,10,-1,1,-1,km,gs#0.00,gs,gs,0.0,8,tanga,ad2,0.265774059691925,0.26470726142732415,0.26684085795652673,0.012775064556327119,41,3575,6515,49779,4821,3616,8604,56294,1,10,1,1246,2089
yago15,-1,isCitizenOf,mean,10,all,adm,0.5,0.5,10,-1,4,1,km,gs#0.00,gs,gs,0.0,7,tanga,ad2,0.11894351296475923,0.11817982943721211,0.11970719649230459,0.011430758175832254,44,4119,6579,47451,4627,4163,7777,54030,1,10,1,508,1198
yago15,-1,isCitizenOf,mean,10,all,adm,0.5,0.5,10,-1,4,-1,km,gs#0.00,gs,gs,0.0,8,tanga,ad2,0.2983630116240285,0.29724830850813105,0.29947771473992646,0.015118830030085247,47,3421,6260,47805,4821,3468,8604,54065,1,10,1,1400,2344
yago15,-1,isCitizenOf,mean,10,all,adm,0.5,0.5,4,-1,1,-1,km,gs#0.00,gs,gs,0.0,3,tanga,ad2,0.14507915910161143,0.1447580512200013,0.1454002669832206,0.013670680563729103,52,3858,6296,13177,4459,3910,7220,19473,1,4,1,601,924
yago15,-1,isCitizenOf,mean,10,all,adm,0.5,0.5,10,-1,2,-1,km,gs#0.00,gs,gs,0.0,0,tanga,ad2,0.12190763433646028,0.12119414997398509,0.12262111869893445,0.011897239484710083,44,3923,5943,42126,4420,3967,7113,48069,1,10,1,497,1170
yago15,-1,isCitizenOf,mean,10,all,adm,0.5,0.5,8,-1,1,-1,km,gs#0.00,gs,gs,0.0,8,tanga,ad2,0.24090060294336516,0.23999275750832122,0.24180844837840537,0.014506274269079363,50,3702,6798,39418,4821,3752,8604,46216,1,8,1,1119,1806
yago15,-1,isCitizenOf,mean,10,all,adm,0.5,0.5,4,-1,1,-1,km,gs#0.00,gs,gs,0.0,0,tanga,ad2,0.2295105461767933,0.22939170472501685,0.2296293876285683,0.012782927915127877,44,3440,4802,8374,4420,3484,7113,13176,1,4,1,980,2311
yago15,-1,isCitizenOf,mean,10,all,adm,0.5,0.5,10,-1,1,-1,km,gs#0.00,gs,gs,0.0,9,tanga,ad2,0.2643550474386148,0.2632424435046231,0.2654676513726073,0.016082426233861375,55,3714,7145,55409,4986,3769,9350,62554,1,10,1,1272,2205
yago15,-1,isCitizenOf,mean,10,all,adm,0.5,0.5,10,-1,1,-1,km,gs#0.00,gs,gs,0.0,0,tanga,ad2,0.12149156042074051,0.12077455739473499,0.1222085634467462,0.011650589242884405,43,3924,5951,42552,4420,3967,7113,48503,1,10,1,496,1162
yago15,-1,isCitizenOf,mean,10,all,adm,0.5,0.5,2,-1,1,-1,km,gs#0.00,gs,gs,0.0,8,tanga,ad2,0.0911651934815516,0.09106088402477212,0.09126950293833055,0.00011584305830703612,0,4382,7800,5309,4821,4382,8604,13109,1,2,1,439,804
yago15,-1,isCitizenOf,mean,10,all,adm,0.5,0.5,4,-1,1,-1,km,gs#0.00,gs,gs,0.0,6,tanga,ad2,0.14511062215633413,0.14476060239125899,0.1454606419214085,0.013506405496090097,52,3917,6487,13831,4528,3969,7425,20318,1,4,1,611,938
yago15,-1,isCitizenOf,mean,10,all,adm,0.5,0.5,10,-1,2,-1,km,gs#0.00,gs,gs,0.0,4,tanga,ad2,0.30260228972469355,0.30159599840268614,0.3036085810467011,0.015490306397037315,45,3154,5269,38081,4471,3199,7242,43350,1,10,1,1317,1973
yago15,-1,isCitizenOf,mean,10,all,adm,0.5,0.5,8,-1,1,-1,km,gs#0.00,gs,gs,0.0,3,tanga,ad2,0.23287674757924065,0.23200104691358062,0.23375244824489896,0.012852742270686727,41,3456,5769,31704,4459,3497,7220,37473,1,8,1,1003,1451
yago15,-1,isCitizenOf,mean,10,all,adm,0.5,0.5,4,-1,1,-1,km,gs#0.00,gs,gs,0.0,7,tanga,ad2,0.1471209187645307,0.14676440200310734,0.1474774355259532,0.013753297046771333,54,3994,6778,14754,4627,4048,7777,21532,1,4,1,633,999
yago15,-1,isCitizenOf,mean,10,all,adm,0.5,0.5,10,-1,4,-1,km,gs#0.00,gs,gs,0.0,7,tanga,ad2,0.2938277314396344,0.29274659912115014,0.2949088637581194,0.015236630026703654,46,3305,5697,42702,4627,3351,7777,48399,1,10,1,1322,2080
yago15,-1,isCitizenOf,mean,10,all,adm,0.5,0.5,2,-1,1,-1,km,gs#0.00,gs,gs,0.0,0,tanga,ad2,0.3807817798630638,0.3807701418889871,0.38079341783714504,2.071799618660892e-05,0,2737,3267,1000,4420,2737,7113,4267,2,2,2,1683,3846
yago15,-1,isCitizenOf,mean,10,all,adm,0.5,0.5,10,-1,3,-1,km,gs#0.00,gs,gs,0.0,3,tanga,ad2,0.25187260817457696,0.2507233142718429,0.2530219020773101,0.014389549151164948,44,3374,5571,40267,4459,3418,7220,45838,1,10,1,1085,1649
yago15,-1,isCitizenOf,mean,10,all,adm,0.5,0.5,10,-1,1,-1,km,gs#0.00,gs,gs,0.0,5,tanga,ad2,0.26189089756320016,0.2608898611362112,0.2628919339901878,0.013163862101951702,40,3343,5557,40730,4483,3383,7287,46287,1,10,1,1140,1730
yago15,-1,isCitizenOf,mean,10,all,adm,0.5,0.5,8,-1,1,-1,km,gs#0.00,gs,gs,0.0,1,tanga,ad2,0.2310523082501256,0.23032316364835018,0.23178145285189938,0.013275941787022901,43,3442,5698,31001,4429,3485,7145,36699,1,8,1,987,1447
yago15,-1,isCitizenOf,mean,10,all,adm,0.5,0.5,10,-1,4,-1,km,gs#0.00,gs,gs,0.0,4,tanga,ad2,0.29726775255395,0.2962153307733874,0.2983201743345134,0.015739339394867036,46,3179,5292,38723,4471,3225,7242,44015,1,10,1,1292,1950
yago15,-1,isCitizenOf,mean,10,all,adm,0.5,0.5,4,-1,1,-1,km,gs#0.00,gs,gs,0.0,2,tanga,ad2,0.15214832067183442,0.15186005252296808,0.1524365888206996,0.013804297681665769,52,3809,6159,12736,4439,3861,7178,18895,1,4,1,630,1019
yago15,-1,isCitizenOf,mean,10,all,adm,0.5,0.5,10,-1,4,-1,km,gs#0.00,gs,gs,0.0,2,tanga,ad2,0.29514488959840873,0.29409222616202385,0.2961975530347935,0.015792512465884,46,3166,5287,38684,4439,3212,7178,43971,1,10,1,1273,1891
yago15,-1,isCitizenOf,mean,10,all,adm,0.5,0.5,2,-1,1,-1,km,gs#0.00,gs,gs,0.0,1,tanga,ad2,0.21588843409055664,0.21585088448785422,0.2159259836932563,4.9054298641745646e-05,0,3473,5047,2616,4429,3473,7145,7663,1,2,1,956,2098
yago15,-1,isCitizenOf,mean,10,all,adm,0.5,0.5,6,-1,1,-1,km,gs#0.00,gs,gs,0.0,2,tanga,ad2,0.20020643635475513,0.19964448438791862,0.20076838832158808,0.012810072489501438,44,3588,5858,21681,4439,3632,7178,27539,1,6,1,851,1320
yago15,-1,isCitizenOf,mean,10,all,adm,0.5,0.5,8,-1,1,-1,km,gs#0.00,gs,gs,0.0,9,tanga,ad2,0.2397866713349272,0.23884229067726778,0.24073105199258577,0.015355909241327787,55,3837,7449,44042,4986,3892,9350,51491,1,8,1,1149,1901
yago15,-1,isCitizenOf,mean,10,all,adm,0.5,0.5,8,-1,1,-1,km,gs#0.00,gs,gs,0.0,2,tanga,ad2,0.23386952532751937,0.23303695491868584,0.23470209573635067,0.012866343147084984,41,3436,5725,31300,4439,3477,7178,37025,1,8,1,1003,1453
yago15,-1,isCitizenOf,mean,10,all,adm,0.5,0.5,8,-1,1,-1,km,gs#0.00,gs,gs,0.0,0,tanga,ad2,0.13371261163898734,0.13321635548043034,0.13420886779754304,0.01055977689877463,39,3865,5828,30821,4420,3904,7113,36649,1,8,1,555,1285
yago15,-1,isCitizenOf,mean,10,all,adm,0.5,0.5,10,-1,4,-1,km,gs#0.00,gs,gs,0.0,0,tanga,ad2,0.1267261528638969,0.12600965665322095,0.1274426490745718,0.01295552164077895,48,3905,5938,42331,4420,3953,7113,48269,1,10,1,515,1175
yago15,-1,isCitizenOf,mean,10,all,adm,0.5,0.5,10,-1,4,-1,km,gs#0.00,gs,gs,0.0,6,tanga,ad2,0.29446319090257433,0.29339849157870157,0.2955278902264464,0.015520306402245339,46,3232,5444,40213,4528,3278,7425,45657,1,10,1,1296,1981
yago15,-1,isCitizenOf,mean,10,all,adm,0.5,0.5,8,-1,1,-1,km,gs#0.00,gs,gs,0.0,6,tanga,ad2,0.23680070466069947,0.23593892936405975,0.2376624799573377,0.012724560854846077,41,3491,5907,32804,4528,3532,7425,38711,1,8,1,1037,1518
yago15,-1,isCitizenOf,mean,10,all,adm,0.5,0.5,4,-1,1,-1,km,gs#0.00,gs,gs,0.0,1,tanga,ad2,0.17756210565636005,0.17733734136977344,0.177786869942945,0.014701027934050915,54,3688,5865,11822,4429,3742,7145,17687,1,4,1,741,1280
yago15,-1,isCitizenOf,mean,10,all,adm,0.5,0.5,2,-1,1,-1,km,gs#0.00,gs,gs,0.0,5,tanga,ad2,0.08619557115595253,0.08610399143884533,0.08628715087305922,0.00010127972753014326,0,4097,6616,4081,4483,4097,7287,10697,1,2,1,386,671
yago15,-1,isCitizenOf,mean,10,all,adm,0.5,0.5,10,-1,3,-1,km,gs#0.00,gs,gs,0.0,8,tanga,ad2,0.2555363260471737,0.254361158185404,0.2567114939089444,0.016194443163384094,54,3635,6615,49946,4821,3689,8604,56561,1,10,1,1186,1989
yago15,-1,isCitizenOf,mean,10,all,adm,0.5,0.5,6,-1,1,-1,km,gs#0.00,gs,gs,0.0,4,tanga,ad2,0.20300126027763635,0.2024378097371991,0.20356471081806993,0.01277132813453847,44,3601,5872,21770,4471,3645,7242,27642,1,6,1,870,1370
yago15,-1,isCitizenOf,mean,10,all,adm,0.5,0.5,10,-1,3,-1,km,gs#0.00,gs,gs,0.0,6,tanga,ad2,0.25484325944221947,0.2537206389227588,0.2559658799616787,0.014220231379615547,44,3412,5721,41773,4528,3456,7425,47494,1,10,1,1116,1704
yago15,-1,isCitizenOf,mean,10,all,adm,0.5,0.5,6,-1,1,-1,km,gs#0.00,gs,gs,0.0,5,tanga,ad2,0.20338047025281777,0.20278471526582587,0.20397622523980669,0.012785150607875594,44,3609,5913,22002,4483,3653,7287,27915,1,6,1,874,1374
yago15,-1,isCitizenOf,mean,10,all,adm,0.5,0.5,10,-1,2,-1,km,gs#0.00,gs,gs,0.0,2,tanga,ad2,0.2950169378637424,0.29393651408795446,0.2960973616395318,0.01552731083903507,45,3166,5333,38835,4439,3211,7178,44168,1,10,1,1273,1845
yago15,-1,isCitizenOf,mean,10,all,adm,0.5,0.5,10,-1,2,-1,km,gs#0.00,gs,gs,0.0,8,tanga,ad2,0.30111930985323937,0.3000427063890146,0.3021959133174645,0.014560464431157915,45,3406,6254,47483,4821,3451,8604,53737,1,10,1,1415,2350
yago15,-1,isCitizenOf,mean,10,all,adm,0.5,0.5,10,-1,4,-1,km,gs#0.00,gs,gs,0.0,5,tanga,ad2,0.2964864437090405,0.295430483299865,0.29754240411821464,0.01568984656048817,46,3191,5329,39083,4483,3237,7287,44412,1,10,1,1292,1958
yago15,-1,isCitizenOf,mean,10,all,adm,0.5,0.5,10,-1,1,-1,km,gs#0.00,gs,gs,0.0,2,tanga,ad2,0.25192483936470006,0.250726754872693,0.2531229238567042,0.013360475357465765,40,3356,5564,41075,4439,3396,7178,46639,1,10,1,1083,1614
yago15,-1,isCitizenOf,mean,10,all,adm,0.5,0.5,4,-1,1,-1,km,gs#0.00,gs,gs,0.0,9,tanga,ad2,0.15133229393944128,0.15094056378843626,0.15172402409044516,0.016277254734799934,69,4292,8157,19045,4986,4361,9350,27202,1,4,1,694,1193
yago15,-1,isCitizenOf,mean,10,all,adm,0.5,0.5,2,-1,1,-1,km,gs#0.00,gs,gs,0.0,3,tanga,ad2,0.11018802554754974,0.11011538635056282,0.11026066474453511,8.283387349767013e-05,0,3968,6246,3726,4459,3968,7220,9972,1,2,1,491,974
yago15,-1,isCitizenOf,mean,10,all,adm,0.5,0.5,10,-1,4,-1,km,gs#0.00,gs,gs,0.0,9,tanga,ad2,0.2990147099602526,0.297860766952755,0.30016865296774764,0.01827069492770709,60,3543,6846,53267,4986,3603,9350,60113,1,10,1,1443,2504
yago15,-1,isCitizenOf,mean,10,all,adm,0.5,0.5,10,-1,2,-1,km,gs#0.00,gs,gs,0.0,3,tanga,ad2,0.2943030513763788,0.29329774757152766,0.29530835518122905,0.015348055661343184,45,3183,5321,38378,4459,3228,7220,43699,1,10,1,1276,1899
yago15,-1,isCitizenOf,mean,10,all,adm,0.5,0.5,10,-1,2,-1,km,gs#0.00,gs,gs,0.0,1,tanga,ad2,0.29131102334423264,0.2903757367277988,0.2922463099606668,0.01618660913468308,48,3177,5338,38517,4429,3225,7145,43855,1,10,1,1252,1807
yago15,-1,isCitizenOf,mean,10,all,adm,0.5,0.5,10,-1,4,1,km,gs#0.00,gs,gs,0.0,8,tanga,ad2,0.12296923210102448,0.1221584186041706,0.12378004559787703,0.01427495055850435,58,4283,7194,52964,4821,4341,8604,60158,1,10,1,538,1410
yago15,-1,isCitizenOf,mean,10,all,adm,0.5,0.5,2,-1,1,-1,km,gs#0.00,gs,gs,0.0,6,tanga,ad2,0.08556294970990382,0.08546912946066276,0.0856567699591438,0.00010365452637838314,0,4141,6757,4237,4528,4141,7425,10994,1,2,1,387,668
yago15,-1,isCitizenOf,mean,10,all,adm,0.5,0.5,2,-1,1,-1,km,gs#0.00,gs,gs,0.0,7,tanga,ad2,0.08654685324388092,0.08645006529691106,0.08664364119084964,0.00010705006183565927,0,4227,7072,4561,4627,4227,7777,11633,1,2,1,400,705
yago15,-1,isCitizenOf,mean,10,all,adm,0.5,0.5,10,-1,4,1,km,gs#0.00,gs,gs,0.0,2,tanga,ad2,0.12066425436799402,0.11993148446775219,0.12139702426823494,0.012590894068613906,47,3948,6053,43108,4439,3995,7178,49161,1,10,1,491,1125
yago15,-1,isCitizenOf,mean,10,all,adm,0.5,0.5,2,-1,1,-1,km,gs#0.00,gs,gs,0.0,2,tanga,ad2,0.1442361268255576,0.14417743849303946,0.1442948151580748,6.961684216449193e-05,0,3799,5892,3386,4439,3799,7178,9278,1,2,1,640,1286
yago15,-1,isCitizenOf,mean,10,all,adm,0.5,0.5,4,-1,1,-1,km,gs#0.00,gs,gs,0.0,5,tanga,ad2,0.1441236937901304,0.14377147483313069,0.14447591274712906,0.013621659141896607,52,3883,6380,13467,4483,3935,7287,19847,1,4,1,600,907
