data,sample,sattr,strategy,n_sg,anony_mode,info_loss,alpha_adm,alpha_dm,k,w,l,reset_w,calgo,enforcer_str,enforcer,enforcer_name,max_dist,snapshot_id,algo,galgo,AIL,dm,am,AAIL,num_anonymized_fake_entities,num_anonymized_real_entities,num_real_edges,num_fake_edges,num_raw_entities,num_anonymized_entities,num_raw_edges,num_anonymized_edges,anonymized_anonymity,anonymized_attribute_anonymity,anonymized_degree_anonymity,num_removed_entities,num_removed_edges,fake+discarded
yago15,-1,isCitizenOf,mean,10,all,adm,0.5,0.5,6,-1,1,-1,km,gs#0.00,gs,gs,0,6,tanga,ad2,0.204420004134458,0.203850891806722,0.204989116462191,0.0126517414373378,44,3640,6009,22527,4528,3684,7425,28536,1,6,1,888,1416,932
yago15,-1,isCitizenOf,mean,10,all,adm,0.5,0.5,10,-1,2,-1,km,gs#0.00,gs,gs,0,7,tanga,ad2,0.298553912622366,0.297519102434793,0.299588722809943,0.0149821908083737,45,3282,5672,42033,4627,3327,7777,47705,1,10,1,1345,2105,1390
yago15,-1,isCitizenOf,mean,10,all,adm,0.5,0.5,10,-1,2,-1,km,gs#0.00,gs,gs,0,9,tanga,ad2,0.299292011569563,0.298174294021945,0.300409729117181,0.0149784676035791,48,3533,6834,52777,4986,3581,9350,59611,1,10,1,1453,2516,1501
yago15,-1,isCitizenOf,mean,10,all,adm,0.5,0.5,6,-1,1,-1,km,gs#0.00,gs,gs,0,7,tanga,ad2,0.205752449343935,0.205173433877916,0.206331464809953,0.0145098097809481,52,3719,6292,24025,4627,3771,7777,30317,1,6,1,908,1485,960
yago15,-1,isCitizenOf,mean,10,all,adm,0.5,0.5,10,-1,1,-1,km,gs#0.00,gs,gs,0,4,tanga,ad2,0.260365136039565,0.259367109763612,0.261363162315517,0.0131641436254417,40,3341,5523,40391,4471,3381,7242,45914,1,10,1,1130,1719,1170
yago15,-1,isCitizenOf,mean,10,all,adm,0.5,0.5,10,-1,1,-1,km,gs#0.00,gs,gs,0,3,tanga,ad2,0.260025568739665,0.258947218074837,0.26110391940449,0.0132944940587142,40,3334,5520,40412,4459,3374,7220,45932,1,10,1,1125,1700,1165
yago15,-1,isCitizenOf,mean,10,all,adm,0.5,0.5,8,-1,1,-1,km,gs#0.00,gs,gs,0,4,tanga,ad2,0.234497015208126,0.233600725095568,0.235393305320682,0.0128755271289522,41,3458,5776,31789,4471,3499,7242,37565,1,8,1,1013,1466,1054
yago15,-1,isCitizenOf,mean,10,all,adm,0.5,0.5,10,-1,4,-1,km,gs#0.00,gs,gs,0,1,tanga,ad2,0.287865778121955,0.286926754068682,0.288804802175229,0.0176101881651054,53,3196,5295,38621,4429,3249,7145,43916,1,10,1,1233,1850,1286
yago15,-1,isCitizenOf,mean,10,all,adm,0.5,0.5,8,-1,1,-1,km,gs#0.00,gs,gs,0,7,tanga,ad2,0.236950727478945,0.236076292744856,0.237825162213031,0.0124997515826699,41,3566,6162,34744,4627,3607,7777,40906,1,8,1,1061,1615,1102
yago15,-1,isCitizenOf,mean,10,all,adm,0.5,0.5,6,-1,1,-1,km,gs#0.00,gs,gs,0,1,tanga,ad2,0.21051317325672,0.210057189226304,0.210969157287134,0.0134172548209258,46,3535,5698,20739,4429,3581,7145,26437,1,6,1,894,1447,940
yago15,-1,isCitizenOf,mean,10,all,adm,0.5,0.5,10,-1,2,-1,km,gs#0.00,gs,gs,0,6,tanga,ad2,0.299510392443005,0.298492798195745,0.300527986690267,0.01526669527671,45,3208,5418,39505,4528,3253,7425,44923,1,10,1,1320,2007,1365
yago15,-1,isCitizenOf,mean,10,all,adm,0.5,0.5,10,-1,3,-1,km,gs#0.00,gs,gs,0,5,tanga,ad2,0.256031358144565,0.254917335932372,0.257145380356758,0.0143563679263308,44,3373,5615,40611,4483,3417,7287,46226,1,10,1,1110,1672,1154
yago15,-1,isCitizenOf,mean,10,all,adm,0.5,0.5,10,-1,2,-1,km,gs#0.00,gs,gs,0,5,tanga,ad2,0.301806400163767,0.300796721069684,0.30281607925785,0.015440961969341,45,3166,5303,38424,4483,3211,7287,43727,1,10,1,1317,1984,1362
yago15,-1,isCitizenOf,mean,10,all,adm,0.5,0.5,10,-1,4,-1,km,gs#0.00,gs,gs,0,3,tanga,ad2,0.295394960948158,0.294340642595907,0.296449279300408,0.0157380498996864,46,3179,5279,38607,4459,3225,7220,43886,1,10,1,1280,1941,1326
yago15,-1,isCitizenOf,mean,10,all,adm,0.5,0.5,6,-1,1,-1,km,gs#0.00,gs,gs,0,9,tanga,ad2,0.209086826678973,0.208458232210774,0.209715421147171,0.0191593442530189,75,4006,7589,30567,4986,4081,9350,38156,1,6,1,980,1761,1055
yago15,-1,isCitizenOf,mean,10,all,adm,0.5,0.5,6,-1,1,-1,km,gs#0.00,gs,gs,0,0,tanga,ad2,0.158021340977448,0.157732198216055,0.158310483738839,0.0101034572941396,37,3754,5565,19166,4420,3791,7113,24731,1,6,1,666,1548,703
yago15,-1,isCitizenOf,mean,10,all,adm,0.5,0.5,10,-1,3,-1,km,gs#0.00,gs,gs,0,4,tanga,ad2,0.256705362435476,0.255594853625603,0.257815871245347,0.0143983747137284,44,3361,5576,40243,4471,3405,7242,45819,1,10,1,1110,1666,1154
yago15,-1,isCitizenOf,mean,10,all,adm,0.5,0.5,10,-1,3,-1,km,gs#0.00,gs,gs,0,9,tanga,ad2,0.260539024906426,0.259327471497858,0.261750578314994,0.015874944644321,54,3733,7176,55028,4986,3787,9350,62204,1,10,1,1253,2174,1307
yago15,-1,isCitizenOf,mean,10,all,adm,0.5,0.5,2,-1,1,-1,km,gs#0.00,gs,gs,0,9,tanga,ad2,0.0931723950647584,0.0930614625886301,0.0932833275408872,0.000123350337353271,0,4522,8479,5996,4986,4522,9350,14475,1,2,1,464,871,464
yago15,-1,isCitizenOf,mean,10,all,adm,0.5,0.5,8,-1,1,-1,km,gs#0.00,gs,gs,0,5,tanga,ad2,0.236268082889705,0.235411985864172,0.237124179915235,0.0128221046848084,41,3459,5791,31893,4483,3500,7287,37684,1,8,1,1024,1496,1065
yago15,-1,isCitizenOf,mean,10,all,adm,0.5,0.5,4,-1,1,-1,km,gs#0.00,gs,gs,0,4,tanga,ad2,0.143612993940188,0.143268544309531,0.143957443570844,0.0136393803777521,52,3875,6340,13344,4471,3927,7242,19684,1,4,1,596,902,648
yago15,-1,isCitizenOf,mean,10,all,adm,0.5,0.5,6,-1,1,-1,km,gs#0.00,gs,gs,0,3,tanga,ad2,0.200887964687002,0.200311668254425,0.201464261119575,0.0127843374790114,44,3601,5852,21660,4459,3645,7220,27512,1,6,1,858,1368,902
yago15,-1,isCitizenOf,mean,10,all,adm,0.5,0.5,4,-1,1,-1,km,gs#0.00,gs,gs,0,8,tanga,ad2,0.150047066720464,0.149673183625886,0.15042094981504,0.0153771767529092,63,4153,7485,16885,4821,4216,8604,24370,1,4,1,668,1119,731
yago15,-1,isCitizenOf,mean,10,all,adm,0.5,0.5,2,-1,1,-1,km,gs#0.00,gs,gs,0,4,tanga,ad2,0.0931286167369598,0.0930449972063311,0.0932122362675873,0.0000933,0,4055,6467,3933,4471,4055,7242,10400,1,2,1,416,775,416
yago15,-1,isCitizenOf,mean,10,all,adm,0.5,0.5,10,-1,3,-1,km,gs#0.00,gs,gs,0,2,tanga,ad2,0.25048394402633,0.249387949787654,0.251579938265004,0.0143503943666798,44,3365,5562,39979,4439,3409,7178,45541,1,10,1,1074,1616,1118
yago15,-1,isCitizenOf,mean,10,all,adm,0.5,0.5,10,-1,3,-1,km,gs#0.00,gs,gs,0,7,tanga,ad2,0.253173877340978,0.252034822777117,0.254312931904838,0.0147717810797907,47,3496,5995,44406,4627,3543,7777,50401,1,10,1,1131,1782,1178
yago15,-1,isCitizenOf,mean,10,all,adm,0.5,0.5,6,-1,1,-1,km,gs#0.00,gs,gs,0,8,tanga,ad2,0.210268565011339,0.20966569372589,0.210871436296784,0.0168117663242217,63,3860,6927,27273,4821,3923,8604,34200,1,6,1,961,1677,1024
yago15,-1,isCitizenOf,mean,10,all,adm,0.5,0.5,10,-1,3,-1,km,gs#0.00,gs,gs,0,0,tanga,ad2,0.124140211249729,0.123435522812527,0.124844899686929,0.0119188625661511,44,3913,5935,41843,4420,3957,7113,47778,1,10,1,507,1178,551
yago15,-1,isCitizenOf,mean,10,all,adm,0.5,0.5,10,-1,3,-1,km,gs#0.00,gs,gs,0,1,tanga,ad2,0.249357793986798,0.24838056832937,0.250335019644226,0.0142038744884641,44,3362,5535,39718,4429,3406,7145,45253,1,10,1,1067,1610,1111
yago15,-1,isCitizenOf,mean,10,all,adm,0.5,0.5,10,-1,1,-1,km,gs#0.00,gs,gs,0,1,tanga,ad2,0.246513989194302,0.245528733146976,0.247499245241626,0.0138751107804349,43,3374,5555,40518,4429,3417,7145,46073,1,10,1,1055,1590,1098
yago15,-1,isCitizenOf,mean,10,all,adm,0.5,0.5,10,-1,1,-1,km,gs#0.00,gs,gs,0,7,tanga,ad2,0.260509102843931,0.259482838372667,0.261535367315194,0.0128138031881562,40,3456,5924,44355,4627,3496,7777,50279,1,10,1,1171,1853,1211
yago15,-1,isCitizenOf,mean,10,all,adm,0.5,0.5,10,-1,1,-1,km,gs#0.00,gs,gs,0,6,tanga,ad2,0.260204806042737,0.259195397396339,0.261214214689132,0.0130304668037259,40,3384,5673,41856,4528,3424,7425,47529,1,10,1,1144,1752,1184
yago15,-1,isCitizenOf,mean,10,all,adm,0.5,0.5,10,-1,1,-1,km,gs#0.00,gs,gs,0,8,tanga,ad2,0.265774059691925,0.264707261427324,0.266840857956527,0.0127750645563271,41,3575,6515,49779,4821,3616,8604,56294,1,10,1,1246,2089,1287
yago15,-1,isCitizenOf,mean,10,all,adm,0.5,0.5,10,-1,4,-1,km,gs#0.00,gs,gs,0,8,tanga,ad2,0.298363011624028,0.297248308508131,0.299477714739926,0.0151188300300852,47,3421,6260,47805,4821,3468,8604,54065,1,10,1,1400,2344,1447
yago15,-1,isCitizenOf,mean,10,all,adm,0.5,0.5,4,-1,1,-1,km,gs#0.00,gs,gs,0,3,tanga,ad2,0.145079159101611,0.144758051220001,0.145400266983221,0.0136706805637291,52,3858,6296,13177,4459,3910,7220,19473,1,4,1,601,924,653
yago15,-1,isCitizenOf,mean,10,all,adm,0.5,0.5,10,-1,2,-1,km,gs#0.00,gs,gs,0,0,tanga,ad2,0.12190763433646,0.121194149973985,0.122621118698934,0.0118972394847101,44,3923,5943,42126,4420,3967,7113,48069,1,10,1,497,1170,541
yago15,-1,isCitizenOf,mean,10,all,adm,0.5,0.5,8,-1,1,-1,km,gs#0.00,gs,gs,0,8,tanga,ad2,0.240900602943365,0.239992757508321,0.241808448378405,0.0145062742690794,50,3702,6798,39418,4821,3752,8604,46216,1,8,1,1119,1806,1169
yago15,-1,isCitizenOf,mean,10,all,adm,0.5,0.5,4,-1,1,-1,km,gs#0.00,gs,gs,0,0,tanga,ad2,0.229510546176793,0.229391704725017,0.229629387628568,0.0127829279151279,44,3440,4802,8374,4420,3484,7113,13176,1,4,1,980,2311,1024
yago15,-1,isCitizenOf,mean,10,all,adm,0.5,0.5,10,-1,1,-1,km,gs#0.00,gs,gs,0,9,tanga,ad2,0.264355047438615,0.263242443504623,0.265467651372607,0.0160824262338614,55,3714,7145,55409,4986,3769,9350,62554,1,10,1,1272,2205,1327
yago15,-1,isCitizenOf,mean,10,all,adm,0.5,0.5,10,-1,1,-1,km,gs#0.00,gs,gs,0,0,tanga,ad2,0.121491560420741,0.120774557394735,0.122208563446746,0.0116505892428844,43,3924,5951,42552,4420,3967,7113,48503,1,10,1,496,1162,539
yago15,-1,isCitizenOf,mean,10,all,adm,0.5,0.5,2,-1,1,-1,km,gs#0.00,gs,gs,0,8,tanga,ad2,0.0911651934815516,0.0910608840247721,0.0912695029383306,0.000115843058307036,0,4382,7800,5309,4821,4382,8604,13109,1,2,1,439,804,439
yago15,-1,isCitizenOf,mean,10,all,adm,0.5,0.5,4,-1,1,-1,km,gs#0.00,gs,gs,0,6,tanga,ad2,0.145110622156334,0.144760602391259,0.145460641921409,0.0135064054960901,52,3917,6487,13831,4528,3969,7425,20318,1,4,1,611,938,663
yago15,-1,isCitizenOf,mean,10,all,adm,0.5,0.5,10,-1,2,-1,km,gs#0.00,gs,gs,0,4,tanga,ad2,0.302602289724694,0.301595998402686,0.303608581046701,0.0154903063970373,45,3154,5269,38081,4471,3199,7242,43350,1,10,1,1317,1973,1362
yago15,-1,isCitizenOf,mean,10,all,adm,0.5,0.5,8,-1,1,-1,km,gs#0.00,gs,gs,0,3,tanga,ad2,0.232876747579241,0.232001046913581,0.233752448244899,0.0128527422706867,41,3456,5769,31704,4459,3497,7220,37473,1,8,1,1003,1451,1044
yago15,-1,isCitizenOf,mean,10,all,adm,0.5,0.5,4,-1,1,-1,km,gs#0.00,gs,gs,0,7,tanga,ad2,0.147120918764531,0.146764402003107,0.147477435525953,0.0137532970467713,54,3994,6778,14754,4627,4048,7777,21532,1,4,1,633,999,687
yago15,-1,isCitizenOf,mean,10,all,adm,0.5,0.5,10,-1,4,-1,km,gs#0.00,gs,gs,0,7,tanga,ad2,0.293827731439634,0.29274659912115,0.294908863758119,0.0152366300267037,46,3305,5697,42702,4627,3351,7777,48399,1,10,1,1322,2080,1368
yago15,-1,isCitizenOf,mean,10,all,adm,0.5,0.5,2,-1,1,-1,km,gs#0.00,gs,gs,0,0,tanga,ad2,0.380781779863064,0.380770141888987,0.380793417837145,0.0000207,0,2737,3267,1000,4420,2737,7113,4267,2,2,2,1683,3846,1683
yago15,-1,isCitizenOf,mean,10,all,adm,0.5,0.5,10,-1,3,-1,km,gs#0.00,gs,gs,0,3,tanga,ad2,0.251872608174577,0.250723314271843,0.25302190207731,0.0143895491511649,44,3374,5571,40267,4459,3418,7220,45838,1,10,1,1085,1649,1129
yago15,-1,isCitizenOf,mean,10,all,adm,0.5,0.5,10,-1,1,-1,km,gs#0.00,gs,gs,0,5,tanga,ad2,0.2618908975632,0.260889861136211,0.262891933990188,0.0131638621019517,40,3343,5557,40730,4483,3383,7287,46287,1,10,1,1140,1730,1180
yago15,-1,isCitizenOf,mean,10,all,adm,0.5,0.5,8,-1,1,-1,km,gs#0.00,gs,gs,0,1,tanga,ad2,0.231052308250126,0.23032316364835,0.231781452851899,0.0132759417870229,43,3442,5698,31001,4429,3485,7145,36699,1,8,1,987,1447,1030
yago15,-1,isCitizenOf,mean,10,all,adm,0.5,0.5,10,-1,4,-1,km,gs#0.00,gs,gs,0,4,tanga,ad2,0.29726775255395,0.296215330773387,0.298320174334513,0.015739339394867,46,3179,5292,38723,4471,3225,7242,44015,1,10,1,1292,1950,1338
yago15,-1,isCitizenOf,mean,10,all,adm,0.5,0.5,4,-1,1,-1,km,gs#0.00,gs,gs,0,2,tanga,ad2,0.152148320671834,0.151860052522968,0.1524365888207,0.0138042976816658,52,3809,6159,12736,4439,3861,7178,18895,1,4,1,630,1019,682
yago15,-1,isCitizenOf,mean,10,all,adm,0.5,0.5,10,-1,4,-1,km,gs#0.00,gs,gs,0,2,tanga,ad2,0.295144889598409,0.294092226162024,0.296197553034793,0.015792512465884,46,3166,5287,38684,4439,3212,7178,43971,1,10,1,1273,1891,1319
yago15,-1,isCitizenOf,mean,10,all,adm,0.5,0.5,2,-1,1,-1,km,gs#0.00,gs,gs,0,1,tanga,ad2,0.215888434090557,0.215850884487854,0.215925983693256,0.0000491,0,3473,5047,2616,4429,3473,7145,7663,1,2,1,956,2098,956
yago15,-1,isCitizenOf,mean,10,all,adm,0.5,0.5,6,-1,1,-1,km,gs#0.00,gs,gs,0,2,tanga,ad2,0.200206436354755,0.199644484387919,0.200768388321588,0.0128100724895014,44,3588,5858,21681,4439,3632,7178,27539,1,6,1,851,1320,895
yago15,-1,isCitizenOf,mean,10,all,adm,0.5,0.5,8,-1,1,-1,km,gs#0.00,gs,gs,0,9,tanga,ad2,0.239786671334927,0.238842290677268,0.240731051992586,0.0153559092413278,55,3837,7449,44042,4986,3892,9350,51491,1,8,1,1149,1901,1204
yago15,-1,isCitizenOf,mean,10,all,adm,0.5,0.5,8,-1,1,-1,km,gs#0.00,gs,gs,0,2,tanga,ad2,0.233869525327519,0.233036954918686,0.234702095736351,0.012866343147085,41,3436,5725,31300,4439,3477,7178,37025,1,8,1,1003,1453,1044
yago15,-1,isCitizenOf,mean,10,all,adm,0.5,0.5,8,-1,1,-1,km,gs#0.00,gs,gs,0,0,tanga,ad2,0.133712611638987,0.13321635548043,0.134208867797543,0.0105597768987746,39,3865,5828,30821,4420,3904,7113,36649,1,8,1,555,1285,594
yago15,-1,isCitizenOf,mean,10,all,adm,0.5,0.5,10,-1,4,-1,km,gs#0.00,gs,gs,0,0,tanga,ad2,0.126726152863897,0.126009656653221,0.127442649074572,0.012955521640779,48,3905,5938,42331,4420,3953,7113,48269,1,10,1,515,1175,563
yago15,-1,isCitizenOf,mean,10,all,adm,0.5,0.5,10,-1,4,-1,km,gs#0.00,gs,gs,0,6,tanga,ad2,0.294463190902574,0.293398491578702,0.295527890226446,0.0155203064022453,46,3232,5444,40213,4528,3278,7425,45657,1,10,1,1296,1981,1342
yago15,-1,isCitizenOf,mean,10,all,adm,0.5,0.5,8,-1,1,-1,km,gs#0.00,gs,gs,0,6,tanga,ad2,0.236800704660699,0.23593892936406,0.237662479957338,0.0127245608548461,41,3491,5907,32804,4528,3532,7425,38711,1,8,1,1037,1518,1078
yago15,-1,isCitizenOf,mean,10,all,adm,0.5,0.5,4,-1,1,-1,km,gs#0.00,gs,gs,0,1,tanga,ad2,0.17756210565636,0.177337341369773,0.177786869942945,0.0147010279340509,54,3688,5865,11822,4429,3742,7145,17687,1,4,1,741,1280,795
yago15,-1,isCitizenOf,mean,10,all,adm,0.5,0.5,2,-1,1,-1,km,gs#0.00,gs,gs,0,5,tanga,ad2,0.0861955711559525,0.0861039914388453,0.0862871508730592,0.000101279727530143,0,4097,6616,4081,4483,4097,7287,10697,1,2,1,386,671,386
yago15,-1,isCitizenOf,mean,10,all,adm,0.5,0.5,10,-1,3,-1,km,gs#0.00,gs,gs,0,8,tanga,ad2,0.255536326047174,0.254361158185404,0.256711493908944,0.0161944431633841,54,3635,6615,49946,4821,3689,8604,56561,1,10,1,1186,1989,1240
yago15,-1,isCitizenOf,mean,10,all,adm,0.5,0.5,6,-1,1,-1,km,gs#0.00,gs,gs,0,4,tanga,ad2,0.203001260277636,0.202437809737199,0.20356471081807,0.0127713281345385,44,3601,5872,21770,4471,3645,7242,27642,1,6,1,870,1370,914
yago15,-1,isCitizenOf,mean,10,all,adm,0.5,0.5,10,-1,3,-1,km,gs#0.00,gs,gs,0,6,tanga,ad2,0.254843259442219,0.253720638922759,0.255965879961679,0.0142202313796155,44,3412,5721,41773,4528,3456,7425,47494,1,10,1,1116,1704,1160
yago15,-1,isCitizenOf,mean,10,all,adm,0.5,0.5,6,-1,1,-1,km,gs#0.00,gs,gs,0,5,tanga,ad2,0.203380470252818,0.202784715265826,0.203976225239807,0.0127851506078756,44,3609,5913,22002,4483,3653,7287,27915,1,6,1,874,1374,918
yago15,-1,isCitizenOf,mean,10,all,adm,0.5,0.5,10,-1,2,-1,km,gs#0.00,gs,gs,0,2,tanga,ad2,0.295016937863742,0.293936514087954,0.296097361639532,0.0155273108390351,45,3166,5333,38835,4439,3211,7178,44168,1,10,1,1273,1845,1318
yago15,-1,isCitizenOf,mean,10,all,adm,0.5,0.5,10,-1,2,-1,km,gs#0.00,gs,gs,0,8,tanga,ad2,0.301119309853239,0.300042706389015,0.302195913317464,0.0145604644311579,45,3406,6254,47483,4821,3451,8604,53737,1,10,1,1415,2350,1460
yago15,-1,isCitizenOf,mean,10,all,adm,0.5,0.5,10,-1,4,-1,km,gs#0.00,gs,gs,0,5,tanga,ad2,0.29648644370904,0.295430483299865,0.297542404118215,0.0156898465604882,46,3191,5329,39083,4483,3237,7287,44412,1,10,1,1292,1958,1338
yago15,-1,isCitizenOf,mean,10,all,adm,0.5,0.5,10,-1,1,-1,km,gs#0.00,gs,gs,0,2,tanga,ad2,0.2519248393647,0.250726754872693,0.253122923856704,0.0133604753574658,40,3356,5564,41075,4439,3396,7178,46639,1,10,1,1083,1614,1123
yago15,-1,isCitizenOf,mean,10,all,adm,0.5,0.5,4,-1,1,-1,km,gs#0.00,gs,gs,0,9,tanga,ad2,0.151332293939441,0.150940563788436,0.151724024090445,0.0162772547347999,69,4292,8157,19045,4986,4361,9350,27202,1,4,1,694,1193,763
yago15,-1,isCitizenOf,mean,10,all,adm,0.5,0.5,2,-1,1,-1,km,gs#0.00,gs,gs,0,3,tanga,ad2,0.11018802554755,0.110115386350563,0.110260664744535,0.0000828,0,3968,6246,3726,4459,3968,7220,9972,1,2,1,491,974,491
yago15,-1,isCitizenOf,mean,10,all,adm,0.5,0.5,10,-1,4,-1,km,gs#0.00,gs,gs,0,9,tanga,ad2,0.299014709960253,0.297860766952755,0.300168652967748,0.0182706949277071,60,3543,6846,53267,4986,3603,9350,60113,1,10,1,1443,2504,1503
yago15,-1,isCitizenOf,mean,10,all,adm,0.5,0.5,10,-1,2,-1,km,gs#0.00,gs,gs,0,3,tanga,ad2,0.294303051376379,0.293297747571528,0.295308355181229,0.0153480556613432,45,3183,5321,38378,4459,3228,7220,43699,1,10,1,1276,1899,1321
yago15,-1,isCitizenOf,mean,10,all,adm,0.5,0.5,10,-1,2,-1,km,gs#0.00,gs,gs,0,1,tanga,ad2,0.291311023344233,0.290375736727799,0.292246309960667,0.0161866091346831,48,3177,5338,38517,4429,3225,7145,43855,1,10,1,1252,1807,1300
yago15,-1,isCitizenOf,mean,10,all,adm,0.5,0.5,2,-1,1,-1,km,gs#0.00,gs,gs,0,6,tanga,ad2,0.0855629497099038,0.0854691294606628,0.0856567699591438,0.000103654526378383,0,4141,6757,4237,4528,4141,7425,10994,1,2,1,387,668,387
yago15,-1,isCitizenOf,mean,10,all,adm,0.5,0.5,2,-1,1,-1,km,gs#0.00,gs,gs,0,7,tanga,ad2,0.0865468532438809,0.0864500652969111,0.0866436411908496,0.000107050061835659,0,4227,7072,4561,4627,4227,7777,11633,1,2,1,400,705,400
yago15,-1,isCitizenOf,mean,10,all,adm,0.5,0.5,2,-1,1,-1,km,gs#0.00,gs,gs,0,2,tanga,ad2,0.144236126825558,0.144177438493039,0.144294815158075,0.0000696,0,3799,5892,3386,4439,3799,7178,9278,1,2,1,640,1286,640
yago15,-1,isCitizenOf,mean,10,all,adm,0.5,0.5,4,-1,1,-1,km,gs#0.00,gs,gs,0,5,tanga,ad2,0.14412369379013,0.143771474833131,0.144475912747129,0.0136216591418966,52,3883,6380,13467,4483,3935,7287,19847,1,4,1,600,907,652
